 #   #  #B  
 # #   #### 
   # #  #   
# ## # # ## 
###  # #    
 ##### ## ##
 ###   ## ##
A    #     #
